{
  "吃": "chī",
  "喝": "hē",
  "睡": "shuì",
  "玩": "wán",
  "做": "zuò",
  "买": "mǎi",
  "卖": "mài",
  "开": "kāi",
  "关": "guān",
  "用": "yòng"
}

