{
  "我": "wǒ",
  "你": "nǐ",
  "他": "tā",
  "她": "tā",
  "们": "men",
  "的": "de",
  "了": "le",
  "是": "shì",
  "有": "yǒu",
  "在": "zài"
}

